1;;..	1.;;.	1;;..	1.;.;	1.;..	1.;.;	1.;.;	1.;;.
1;.;.	1;..;	1...;	7.;;.	1;.;.	1;;..	1.;.;	1..;.
1;...	S.;;.	1;;;.	1;..;	1...;	7....	G.;;;	1;.;.
1;.;.	1;...	1..;.	1;;..	1.;;.	1;.;.	1;;.;	1..;.
1;.;.	1;.;;	1;.;.	1;.;.	1;.;.	1;.;.	1;;;.	1;.;.
1;...	1.;.;	1...;	1..;;	1;.;.	1;.;.	G;..;	1..;.
1;...	1.;.;	1.;..	1.;;.	1;.;;	7;..;	1.;;.	7;.;.
1;..;	1.;;;	1;.;;	1;.;;	G;;.;	1.;.;	1..;;	G;.;;
